1111111111
1E0C00P001
1000100001
1000011111
1111111111