111111111
100C00P01
1E0010001
111111111