11111111
1E000P01
10C01001
10000111
11111111