11111111
1E010P01
10C11001
10010111
11111111