1111111111
1E000P0011
10C0100001
1000011111
1111111111