111111111
100C00P01
1000E0001
111111111