111111111111
100000000001
100P0000C001
111111111111
E11111111111