111111111111
11E10P0000C1
110100001001
10000C0000C1
10C000001001
1C0001001001
100000C001C1
1C000C001011
111111111111