1111111111
1000000E11
1011111111
1000P00101
1C00000001
1111111111