1111111111111
1C01C10111111
1001010C11111
10000000100E1
1011110010011
1000010000001
1000P1C0000C1
1111111111111