1111111111111
1001110111111
1C0101C011111
110000CEC1C01
111010C0CC011
1111111PC0111
1111111111111
1111111111111