1111111111111
1C0111C010E01
1001110011011
1000000011011
1011111011011
1000011000001
100P0110000C1
1111111111111