111111
1E0C01
1000C1
1P0001
100001
111111
111111