111111
1E0C01
1000C1
1P0001
111111
111111