1111111111
1$00000@01
1000030001
1000C00E01
1P00000001
1111111111