110100001001
101E00000P01
100000001001
100001001001
100000001011
100000001C11
111111111111