111111111111
1111E0CP1111
10000C011111
1000N0000111
111111111111
111111111111
111111111111