111111111
1E0CP1111
10000C011
100000111
111111111
111111111
111111111