11111111111111
1111E0CP001111
10010010111111
1C00000000C111
11100000111111
10000000000001
11111111111111