1111111111111
10010000000C1
1000011111001
1P0011E000001
1111100000111
1100000011111
1111000000011
1111111111111
1111111111111
1111111111111
1111111111111
1111111111111
1111111111111
1111111111111
1111111111111
1111111111111