1111111111
110E0C0111
1000N0C011
111P000111
1111111111
1111111111
1111111111