111111111111111111111
110EN0001111111111111
1000000C00C0000000001
100000N000C0000000011
10000000N000P00011111
111111111111111111111
111111111111111111111