111111111111
110100001001
101E10000P01
1000N0000011
100001001001
100000001011
100000001C11
111111111111